####################
#....~~~~~~........#
#....~~~~~~........#
#....######........#
#.@..#....#........#
#.........#........#
####################
          
