####################
#....~~~~~~........#
#....~~~~~~........#
#....######........#
#....#....#........#
#.........#........#
####################
          
