##############
#....~~~~~...#
#....~~~~~...#
#....#####...#
#....#...#...#
#........#...#
##############
